Animalia -> Cnidaria, Bilateria
Cnidaria -> ğŸª¼ Blue Jellyfish [Cyanea lamarckii], ğŸª¸ Staghorn Coral [Acropora cervicornis]
Bilateria -> Chordata, Protostomia
Protostomia -> Arthropoda, Spiralia
Spiralia -> Mollusca, ğŸª± Common Earthworm [Lumbricus terrestris]
Mollusca -> ğŸ¦ª Pacific Oyster [Magallana gigas], GC
GC -> Gastropoda, Cephalopoda
Gastropoda -> ğŸŒ Garden Snail [Cornu aspersum], ğŸš Florida Crown Conch [Melongena corona]
Cephalopoda -> ğŸ™ Common Octopus [Octopus vulgaris], ğŸ¦‘ Giant Squid [Architeuthis dux]
Arthropoda -> Pancrustacea, Arachnida
Arachnida -> ğŸ•·ï¸ Black House Spider [Badumna insignis], ğŸ¦‚ Arizona Bark Scorpion [Centruroides sculpturatus]
Pancrustacea -> Insecta, Malacostraca
Malacostraca -> Reptantia, ğŸ¦ Emperor Shrimp [Zenopontonia rex]
Reptantia -> ğŸ¦€ Dungeness Crab [Metacarcinus magister], ğŸ¦ European Lobster [Homarus gammarus]
Insecta -> Polyneoptera, Holometabola
Polyneoptera -> ğŸ¦— Great Green Bush-Cricket [Tettigonia viridissima], ğŸª³ German Cockroach [Blattella germanica]
Holometabola -> Hymenoptera, NP
Hymenoptera -> ğŸœ Black Garden Ant [Lasius niger], ğŸ Western Honey Bee [Apis mellifera]
NP -> Coleoptera, Panorpida
Coleoptera -> ğŸª² Golden Stag Beetle [Lamprima aurata], ğŸ Seven-Spotted Ladybug [Coccinella septempunctata]
Panorpida -> ğŸ¦‹ Monarch Butterfly [Danaus plexippus], Diptera
Diptera -> ğŸ¦Ÿ Common House Mosquito [Culex pipiens], ğŸª° Housefly [Musca domestica]
Chordata -> ğŸ¦ˆ Great White Shark [Carcharodon carcharias], Euteleostomi
Euteleostomi -> Actinopterygii, Tetrapoda
Actinopterygii -> Ovalentaria, ğŸ¡ White-Spotted Puffer [Arothron hispidus]
Ovalentaria -> ğŸŸ Neon Damselfish [Pomacentrus coelestis], ğŸ  Freshwater Angelfish [Pterophyllum scalare]
Tetrapoda -> ğŸ¸ American Bullfrog [Lithobates catesbeianus], Amniota
Amniota -> Mammalia, Sauria
Sauria -> Squamata, Archelosauria
Squamata -> ğŸ¦ Common House Gecko [Hemidactylus frenatus], ğŸ Smooth Green Snake [Opheodrys vernalis]
Archelosauria -> ğŸ¢ European Pond Turtle [Emys orbicularis], Archosauria
Archosauria -> ğŸŠ American Crocodile [Crocodylus acutus], Dinosauria
Dinosauria -> ğŸ¦• Brachiosaurus [Brachiosaurus altithorax] â€ , Theropoda
Theropoda -> ğŸ¦– T-Rex [Tyrannosaurus rex] â€ , Aves
Aves -> Galloanserae, Neoaves
Galloanserae -> Galliformes, Anseriformes
Galliformes -> ğŸ¦ƒ Wild Turkey [Meleagris gallopavo], PG
PG -> ğŸ“ Red Junglefowl [Gallus gallus], ğŸ¦š Indian Peafowl [Pavo cristatus]
Anseriformes -> ğŸ¦† Mallard [Anas platyrhynchos], Anserinae
Anserinae -> ğŸª¿ Greylag Goose [Anser anser], ğŸ¦¢ Mute Swan [Cygnus olor]
Neoaves -> ğŸ¦© Greater Flamingo [Phoenicopterus roseus], CP
CP -> Columbidae, ET
Columbidae -> ğŸ•Šï¸ Rock Dove [Columba livia], ğŸ¦¤ Dodo [Raphus cucullatus] â€ 
ET -> ğŸ§ Gentoo Penguin [Pygoscelis papua], Telluraves
Telluraves -> Hieraves, Psittacopasseres
Hieraves -> ğŸ¦… Bald Eagle [Haliaeetus leucocephalus], ğŸ¦‰ Great Horned Owl [Bubo virginianus]
Psittacopasseres -> ğŸ¦œ Scarlet Macaw [Ara macao], Passeriformes
Passeriformes -> ğŸ¦â€â¬› Common Blackbird [Turdus merula], ğŸ¦ Northern Cardinal [Cardinalis cardinalis]
Mammalia -> Diprotodontia, Placentalia
Diprotodontia -> ğŸ¦˜ Red Kangaroo [Osphranter rufus], ğŸ¨ Koala [Phascolarctos cinereus]
Placentalia -> Boreoeutheria, Atlantogenata
Atlantogenata -> ğŸ¦¥ Brown-Throated Sloth [Bradypus variegatus], Elephantidae
Elephantidae -> ğŸ˜ Asian Elephant [Elephas maximus], ğŸ¦£ Woolly Mammoth [Mammuthus primigenius] â€ 
Boreoeutheria -> Euarchontoglires, Laurasiatheria
Euarchontoglires -> Glires, Primates
Primates -> ğŸ’ Brown Spider Monkey [Ateles hybridus], Hominidae
Hominidae -> ğŸ¦§ Bornean Orangutan [Pongo pygmaeus], ğŸ¦ Western Gorilla [Gorilla gorilla]
Glires -> ğŸ‡ Snowshoe Hare [Lepus americanus], Rodentia
Rodentia -> ğŸ¿ï¸ Eastern Chipmunk [Tamias striatus], CM
CM -> ğŸ¦« North American Beaver [Castor canadensis], Muroidea
Muroidea -> ğŸ¹ European Hamster [Cricetus cricetus], Muridae
Muridae -> ğŸ House Mouse [Mus musculus], ğŸ€ Black Rat [Rattus rattus]
Laurasiatheria -> ğŸ¦” European Hedgehog [Erinaceus europaeus], Scrotifera
Scrotifera -> ğŸ¦‡ Egyptian Fruit Bat [Rousettus aegyptiacus], Ferungulata
Ferungulata -> Carnivora, Euungulata
Carnivora -> Felidae, Caniformia
Felidae -> ğŸˆ Cat [Felis catus], Panthera
Panthera -> LL, ğŸ… Tiger [Panthera tigris]
LL -> ğŸ¦ Lion [Panthera leo], ğŸ† Leopard [Panthera pardus]
Caniformia -> Canidae, Arctoidea
Canidae -> ğŸ¦Š Red Fox [Vulpes vulpes], Canis
Canis -> ğŸ• Dog [Canis familiaris], ğŸº Wolf [Canis lupus]
Arctoidea -> Ursidae, Mustelida
Ursidae -> ğŸ¼ Giant Panda [Ailuropoda melanoleuca], Ursus
Ursus -> ğŸ» Brown Bear [Ursus arctos], ğŸ»â€â„ï¸ Polar Bear [Ursus maritimus]
Mustelida -> ğŸ¦­ Harbour Seal [Phoca vitulina], Musteloidea
Musteloidea -> ğŸ¦¨ Striped Skunk [Mephitis mephitis] , PM
PM -> ğŸ¦ Raccoon [Procyon lotor], Mustelidae
Mustelidae -> ğŸ¦¡ American Badger [Taxidea taxus], ğŸ¦¦ Eurasian Otter [Lutra lutra]
Euungulata -> Perissodactyla, Artiodactyla
Perissodactyla -> Equidae, ğŸ¦ White Rhinoceros [Ceratotherium simum]
Equidae -> DZ, ğŸ Wild Horse [Equus ferus]
DZ -> ğŸ« African Wild Ass [Equus africanus], ğŸ¦“ Plains Zebra [Equus quagga] 
Artiodactyla -> Camelidae, Artiofabula
Camelidae -> ğŸ¦™ Llama [Lama glama], Camelus
Camelus -> ğŸª Dromedary [Camelus dromedarius], ğŸ« Bactrian Camel [Camelus bactrianus]
Artiofabula -> Suidae, Cetruminantia
Suidae -> ğŸ– Pig [Sus domesticus], ğŸ— Wild Boar [Sus scrofa]
Cetruminantia -> Ruminantia, Whippomorpha
Whippomorpha -> ğŸ¦› Hippopotamus [Hippopotamus amphibius], Cetacea
Cetacea -> ğŸ‹ Blue Whale [Balaenoptera musculus], ğŸ¬ Common Bottlenose Dolphin [Tursiops truncatus]
Ruminantia -> BC, ğŸ¦’ Reticulated Giraffe [Giraffa reticulata]
BC -> Bovidae, Cervidae
Cervidae -> ğŸ¦Œ White-Tailed Deer [Odocoileus virginianus], ğŸ« Moose [Alces alces]
Bovidae -> Bovini, Caprinae
Caprinae -> ğŸ Sheep [Ovis aries], ğŸ Goat [Capra hircus]
Bovini -> Bovina, ğŸƒ Water Buffalo [Bubalus bubalis]
Bovina -> ğŸ„ Cattle [Bos taurus], ğŸ¦¬ American Bison [Bison bison]